WWWWWWWWWWWWWWWWWWWWWWWWWWWW
WPPPPPPPPPPPPWWPPPPPPPPPPPPW
WPWWWWPWWWWWPWWPWWWWWPWWWWPW
WPPPPPPPPPPPPPPPPPPPPPPPPPPW
WPWWWWPWPWWWWWWWWWWPWPWWWWPW
WPPPPPPWPPPPPWWPPPPPWPPPPPPW
WWWWWWPWWWWWEWWEWWWWWPWWWWWW
EEEEEWPWWWWWEWWEWWWWWPWEEEEE
EEEEEWPWWEEEEEEEEEEWWPWEEEEE
WWWWWWPWWEWWWWWWWWEWWPWWWWWW
EEEEEEPEEEWEEEEEEWEEEPEEEEEE
WWWWWWPWWEWWWWWWWWEWWPWWWWWW
EEEEEWPWWEEEEEEEEEEWWPWEEEEE
EEEEEWPWWEWWWWWWWWEWWPWEEEEE
WWWWWWPWWEWWWWWWWWEWWPWWWWWW
WPPPPPPPPPPPPWWPPPPPPPPPPPPW
WPWWWWPWWWWWPWWPWWWWWPWWWWPW
WPWWWWPWWWWWPWWPWWWWWPWWWWPW
WPPPWWPPPPPPPEEPPPPPPPWWPPPW
WWWPWWPWWPWWWWWWWWPWWPWWPWWW
WWWPWWPWWPWWWWWWWWPWWPWWPWWW
WPPPPPPWWPPPPWWPPPPWWPPPPPPW
WPWWWWWWWWWWPWWPWWWWWWWWWWPW
WPPPPPPPPPPPPPPPPPPPPPPPPPPW
WWWWWWWWWWWWWWWWWWWWWWWWWWWW